baiiiwwwwwwwwww
wwwwwwwwwwwwwww
w0ww0ww0wwww0ww
w00w00w0w0w000w
w0ww00w000ww0ww
w0000w0ww0000ww
wwww0w0000w000w
w0000w0www00w0w
w0w0w00www0000w
w0w00000000w0ww
w00w0w0w0ww000w
ww000w0w0000w0w
w00w00w0www000w
w0w00ww00000www
wwwwwwwewwwwwww